            ___             
         __|FFF|__          
        |.........|         
        |.........|         
        |.........|         
        |__ ... __|         
           |TTT|            
                            
