            ___             
         __|...|__          
        |.........|         
        |....@....|         
        |.........|         
        |__ ... __|         
           |___|            
                            
