            ___             
         __|FFF|__          
        |.........|         
        |.........|         
        |.........|         
        |__.TTT.__|         
           |___|            
                            
